1111111111111111111111111111
1E0000000C00000C000000000001
1010100000101001000000010101
1010001010001001000000010101
1P00000C000000000000000000C1
1111111111111111111111111111
